1111111111111
1001C000000C1
100C011111001
1PC011E000001
1111111111111